999,999,999,999,999,999,999,999,999,999,999,999,999,999,999,999,999,999,999,999
999,000,000,999,000,000,000,000,000,000,999,000,000,999,000,000,000,000,000,999
999,000,000,999,000,999,999,999,999,000,999,999,000,999,000,000,999,000,000,999
999,999,000,999,000,000,000,999,000,000,000,999,000,999,000,999,999,999,000,999
999,000,000,999,000,999,999,999,000,000,000,999,000,999,000,000,999,000,000,999
999,000,999,999,000,000,000,999,999,999,999,999,000,999,000,000,000,000,000,999
999,000,000,000,000,000,000,999,000,000,000,999,000,000,000,999,999,999,000,999
999,000,000,999,000,000,000,999,000,999,000,999,999,999,000,000,999,000,000,999
999,000,999,999,999,000,999,999,000,999,000,000,000,000,000,999,999,999,000,999
999,000,000,999,000,000,000,999,999,999,000,999,000,000,000,000,000,000,000,999
999,000,000,000,000,999,000,000,999,000,000,999,000,999,999,999,000,999,999,999
999,999,999,000,999,999,999,000,999,000,000,000,000,999,000,000,000,000,000,999
999,000,000,000,000,999,000,000,999,999,999,999,000,999,000,000,000,000,000,999
999,000,000,000,000,000,000,000,000,000,000,000,000,999,000,000,000,000,000,999
999,999,999,999,999,999,999,999,999,999,999,999,999,999,999,999,999,999,999,999